[
    "      P          ",
    "                 ",
    "        K        ",
    "      X          ",
    "      XXXX v     ",
    "      X X        ",
    "                 ",
    "       T   <     "
]