[
    "      P          ",
    "                 ",
    "        K        ",
    "      X          ",
    "      XXXX v  C  ",
    "      X X        ",
    "                 ",
    "       T   <     ",
    "                 ",
    "                 ",
    "     M A D       ",
    "                 ",
    "                 ",
    "                 "
]